________________________________________
________________________________________
|                                      |
|                                      |
|                                      |
|                                      |
|                                      |
|                                      |
|                       P              |
|                                      |
|                                      |
|                                      |
|                                      |
|                       0              |
|                                      |
|                                      |
|                                      |
|                                      |
|                                      |
|                                      |
|                                      |
|                                      |
|                                      |
|                                      |
|                                      |
|                                      |
|                                      |
|                                      |
|                                      |
|                                      |
|                                      |
|                                      |
|                                      |
|                                      |
|                                      |
|                                      |
|                                      |
|                                      |
|                                      |
|                                      |
________________________________________