________________________________________
________________________________________
|                                      |
|                                      |
|                                      |
|                                      |
|  111111111111111111111111    11111111|
|  1                      1    1       |
|  1 0                  P 1    1 0   1 |
|  1                      1    1       |
|  1   P              0   1    1       |
|  1                      1    1       |
|  1 P                    1    1       |
|  1                      111111     2 |
|  11111111111111111111                |
|                     1            1111|
|                     1    1111    1   |
|1111111111111111111111 0  1111    1   |
|11                        1111    1   |
|11 4                           5P 1   |
|                                  1   |
| 2 3                              1   |
|                                  1   |
| 1                              0 1   |
|                                  1   |
|11111111111111111111111111111111111   |
|                                      |
|                                      |
|                                      |
|                                      |
|                                      |
|                                      |
|                                      |
|                                      |
|                                      |
|                                      |
|                                      |
|                                      |
|                                      |
|                                      |
________________________________________