________________________________________
|                                      |
|                                      |
|                                      |
|                                      |
|                                      |
|   22                                 |
|   22                                 |
|   22                                 |
|   22                                 |
|   22                                 |
|   33                                 |
|   44                                 |
|                                      |
|                      22              |
|                      22              |
|                                      |
|                                      |
|                                      |
|                  v                   |
|                                      |
|                                      |
|                                      |
|                                      |
|                                      |
|                                      |
|                                      |
|                                      |
|                                      |
|                                      |
|                                      |
|                                      |
|                                      |
|                                      |
|                                      |
|                                      |
|                                      |
|                                      |
|                                      |
________________________________________
|                                      |
|                                      |
|                                      |
|                                      |
|  111111111111111111111111    11111111|
|  1                      1    1       |
|  1                      1    1       |
|  1                      1    1       |
|  1                      1    1       |
|  1                      1    1       |
|  1                      1    1       |
|  1                      111111       |
|  11111111111111111111                |
|                     1            1111|
|                     1            1   |
|1111111111111111111111            1   |
|21                                1   |
|11                                1   |
|                    1             1   |
|1            1                1   1   |
|                                  1   |
|                                  1   |
|                                  1   |
|11111111111111111111111111111111111   |
|                                      |
|1111111111111111111111111111111       |
|1111111111111111111111111111111       |
|1111111111111111111111111111111       |
|                            1         |
|11111111111111111111111111111111111   |
|33333222222222222222111111111111111   |
|33333322222222222222211111111111111 H |
|33333332222222222222221111111111111   |
|33333322222222222222211111111111111   |
|33333222222222222222111111111111111 H |
|11111111111111111111111111111111111   |
|                                      |
|                                      |
________________________________________
|                                      |
| H  H  H  H  H  H  H  H  H  H  H  H  H|
|                                      |
|   33333333333333333333333333333333333|
| H 33333333333333333333333333333333333|
|                         322223       |
|                         322223       |
| H                       322223       |
|                         322223       |
|                         322223       |
| H                       322223       |
|                         333333       |
|   3333333333333333333                |
| H 3333333333333333333            3333|
|   3333333333333333333            3333|
|3333333333333333333333            3   |
|                                  3 H |
| s                                3   |
|                    l             3   |
|e            s                e   3 H |
|                                  3   |
|                                  3   |
|                                  3 H |
|3333333333333QN 3333 h 333333333333   |
|333333333333333333333333333333333     |
|Q                              33 H  H|
|QQ         a                   33     |
|QQ                             33     |
|3333333333333333333333333333 3333 H  H|
|3333333333333333333333333333 3333     |
|                                 {3   |
|                                 {3 H |
|                                 {3   |
|                                 {3   |
|                                 {3 H |
|33333333333333333333333333333333333   |
|                                      |
| H  H  H  H  H  H  H  H  H  H  H  H  H|
________________________________________
|                                      |
|                                      |
|                                      |
|                                      |
|                                      |
|                                      |
|    p                                 |
|                                      |
|                                      |
|                                      |
|                                      |
|                                      |
|                                      |
|                                      |
|                                      |
|                                      |
|                                      |
|                                      |
|                                      |
|                                      |
|                                      |
|                                      |
|                                      |
|                                      |
|                                      |
|      D          D          D         |
|Q                                     |
|Q     U          U                    |
|                                      |
|                                      |
|                                 {    |
|                                 {    |
|                                 {    |
|                                 {    |
|                                 {    |
|                                      |
|                                      |
|                                      |
________________________________________
|                                      |
|                                      |
|                                      |
|                                      |
|                                      |
|    D       D       D                 |
|                                      |
|                        L e    R      |
|                          Q A         |
|                        L ASS  R      |
|                                      |
|     U       U       U                |
|                                      |
|                    11111111111111    |
|                    11111111111111    |
|                                      |
|     D       D       D                |
|                                      |
|                                      |
|                                 L    |
|                                      |
|                                      |
|      U       U       U      U        |
|             111    111               |
|                                      |
|1111111111111111111111111111111       |
|1111111111111111111111111111111       |
|1111111111111111111111111111111       |
|                            1         |
|                            1         |
|         D       D       D       {    |
|                                 {    |
|                                 {    |
|                                 {    |
|     U       U       U       U   {    |
|                                      |
|                                      |
|                                      |
________________________________________
|                l d l                 |
|                  C                   |
|                                      |
|                                      |
|  2kkkkkkkkkkkkkkkkkkkkkk3    3kkkkkk2|
|  K                      3    3       |
|  K                      3    3       |
|  K                      3    3       |
|  K                      3    3       |
|  K                      3    3       |
|  K                      3    3       |
|  K                      3l  l3       |
|  2  2kkkkkkkkkkkkkkk2                |
|                     <                |
|                     <                |
|2kkkkkkkkkkkkkkkkkkkk2            2   |
|                                  K   |
|                                  K   |
|                                  K   |
|                                  K   |
|                                  K   |
|                                  K   |
|                                  K   |
|2kkkkkkkkkkkkkkkkkkkkkkkkkkkkkkkkk2   |
| <                                    |
|W<                                    |
|P<                                    |
|W<                                    |
| <                                    |
|2kkkkkkkkkkkkkkkkkkkkkkkkkkkkkkkkk2   |
|                                 {K   |
|                                 {K   |
|                                 {K   |
|                                 {K   |
|                                 {K   |
|   2kkkkkkkkkkkkkkkkkkkkkkkkkkkkkk2   |
|                                      |
|                                      |
________________________________________
|                                      |
|                                      |
|                                      |
|                                      |
|                                      |
|                                      |
|                                      |
|                                      |
|                                      |
|                                      |
|                                      |
|                                      |
|                      R               |
|  D  D                                |
|                                      |
|                      R               |
|                                      |
|                                      |
|                                      |
|                                      |
|                                      |
|                                      |
|                                      |
|                                   R  |
|                                      |
|                                      |
|                                      |
|                                      |
|                                      |
|                                   R  |
|                                      |
|                                      |
|                                      |
|                                      |
|                                      |
|                                      |
|   D                                  |
|                                      |
________________________________________
________________________________________
|  D           D        D           D  |
|                                      |
|R                                     |
|                         U    U       |
|                         2    2       |
|                         2    2       |
|                         2    2       |
|                         2    2       |
|R                        2    2       |
|                         2    2       |
|                         2    2       |
|                         2    2       |
|                         D    D       |
|                                      |
|R                                    L|
|                                      |
|                                      |
|                                      |
|                                      |
|                                      |
|                                     L|
|                                      |
|                                      |
|                                      |
|R                                     |
|                                      |
|                                     L|
|                                      |
|R                                     |
|                                      |
|                                      |
|                                      |
|                                     L|
|                                      |
|                                      |
|                                      |
|                                      |
|  U           U        U           U  |
________________________________________
|                                      |
|                                      |
|                                      |
|                                      |
|                          1111        |
|                          1111        |
|                          1111        |
|                          1111        |
|                          1111        |
|                          1111        |
|                          1111        |
|                          1111        |
|                                      |
|                                      |
|                                      |
|                                      |
|                                      |
|                                      |
|                                      |
|                                      |
|                                      |
|                                      |
|                                      |
|                                      |
|                                      |
|                                      |
|                                      |
|                                      |
|                                      |
|                                      |
|                                      |
|                                      |
|                                      |
|                                      |
|                                      |
|                                      |
|                                      |
|                                      |
________________________________________