________________________________________
________________________________________
|                                      |
|                                      |
|                                      |
|                                      |
|                                      |
|                                      |
|                                      |
|                                      |
|                                      |
|                                      |
|                                      |
|                                      |
|                                      |
|                                  23  |
|                       1              |
|                                      |
|                                      |
|               0                      |
|                                      |
|                                      |
|                             4        |
|                                      |
|                                      |
|                                      |
|                                      |
________________________________________
________________________________________
________________________________________
________________________________________
________________________________________
________________________________________
________________________________________
________________________________________
________________________________________
|                                      |
|                                      |
|                                      |
|                                      |
|                                      |
|                                      |
|                                      |
|                                      |
|                                      |
|                                    d |
|                                      |
|                              c       |
|                                      |
|                                      |
|                                      |
|                                      |
|                                      |
|                     e                |
|                                      |
|      a                               |
|                                      |
|                          b           |
|                                      |
|                                      |
|                                      |
________________________________________