________________________________________
|                                      |
|                                      |
|                                      |
|                                      |
|                                      |
|                                      |
|                                      |
|                                      |
|                                      |
|                                      |
|                                      |
|                                      |
|                                      |
|                                      |
|                                      |
|                                      |
|                                      |
|                                      |
|                  v                   |
|                                      |
|                                      |
|                                      |
|                                      |
|                                      |
|                                      |
|                                      |
|                                      |
|                                      |
|                                      |
|                                      |
|                                      |
|                                      |
|                                      |
|                                      |
|                                      |
|                                      |
|                                      |
|                                      |
________________________________________
|                                      |
| H  H  H  H  H  H  H  H  H  H  H  H  H|
|                                      |
|   33333333333333333333333333333333333|
| H                         333333     |
|                           322223     |
|                           322223     |
| H                         322223     |
|                           322223     |
|                           322223     |
| H                         322223     |
|                           333333     |
|                                      |
| H 3333333333333333333                |
|   3333333333333333333                |
|3333333333333333333333                |
|                                      |
|                                      |
|                                      |
|                                      |
|                                      |
|                                      |
|                                      |
|                                      |
|                                      |
|                                      |
|                                      |
|                                      |
|                                      |
|                                      |
|                                      |
|                                      |
|                                      |
|                                      |
|                                      |
|                                      |
|                                      |
|                                      |
________________________________________
________________________________________
|                                      |
|                                      |
|                                      |
|                                      |
|                                      |
|                                      |
|                                      |
|                                      |
|                                      |
|                                      |
|                                      |
|                                      |
|                                      |
|                                      |
|                      11111111111     |
|                                      |
|                                      |
|                                      |
|                                      |
|                                      |
|                                      |
|                                      |
|                                      |
|                                      |
|                                      |
|                                      |
|                                      |
|                                      |
|                                      |
|                                      |
|                                      |
|                                      |
|                                      |
|                                      |
|                                      |
|                                      |
|                                      |
|                                      |
________________________________________
|                l d l                 |
|                  C                   |
|                                      |
|                                      |
|                           3    3     |
|                           3    3     |
|                           3    3     |
|                           3    3     |
|                           3    3     |
|                           3    3     |
|                           3    3     |
|                           3l  l3     |
|                                      |
|                                      |
|                                      |
|                                      |
|                                      |
|                                      |
|                                      |
|                                      |
|                                      |
|                                      |
|                                      |
|                                      |
|                                      |
|                                      |
|                                      |
|                                      |
|                                      |
|                                      |
|                                      |
|                                      |
|                                      |
|                                      |
|                                      |
|                                      |
|                                      |
|                                      |
________________________________________
________________________________________
________________________________________
|  D     D     D        D     D     D  |
|                                      |
|R                                     |
|                           U    U     |
|                           2    2     |
|                          L2    2R    |
|                           2    2     |
|                           2    2     |
|R                          2    2     |
|                          L2    2R    |
|                           2    2     |
|                           2    2     |
|                           D    D     |
|                                      |
|R                                     |
|                                      |
|                                      |
|                                      |
|                                      |
|                                      |
|                                      |
|                                      |
|                                      |
|                                      |
|                                      |
|                                      |
|                                      |
|                                      |
|                                      |
|                                      |
|                                      |
|                                      |
|                                      |
|                                      |
|                                      |
|                                      |
|                                      |
|                                      |
________________________________________
|                                      |
|                                      |
|                                      |
|                                      |
|                            1111      |
|                            1111      |
|                            1111      |
|                            1111      |
|                            1111      |
|                            1111      |
|                            1111      |
|                            1111      |
|                                      |
|                                      |
|                                      |
|                                      |
|                                      |
|                                      |
|                                      |
|                                      |
|                                      |
|                                      |
|                                      |
|                                      |
|                                      |
|                                      |
|                                      |
|                                      |
|                                      |
|                                      |
|                                      |
|                                      |
|                                      |
|                                      |
|                                      |
|                                      |
|                                      |
|                                      |
________________________________________