________________________________________
|OOO               d               X   |
|OO                                 X  |
|O                 C                 X |
|                                     X|
|                                      |
|                                      |
|                                      |
|         H                  H         |
|                                      |
|                                      |
|                                      |
|                                      |
|                                      |
|         H                  H         |
|                                      |
|                                      |
|         H                  H         |
|                                      |
|                                      |
|e        H        F         H        w|
|                                      |
|                                      |
|         H                  H         |
|                                      |
|                                      |
|         H                  H         |
|                                      |
|                                      |
|                                      |
|                                      |
|                                      |
|         H     H  H  H      H         |
|                                      |
|                                      |
|                                      |
|                                      |
|                                     O|
|X             n   d   n             OO|
________________________________________
|OO                                 X  |
|O                                   X |
|                                     X|
________________________________________
|O                                   XX|
|                                     X|
|                                      |
|                                      |
|                                      |
|                                      |
|                                      |
|       L   R              L   R       |
|                                      |
|                                      |
|                                      |
|                                      |
|                                      |
|                                      |
|                                      |
|                                      |
|       L   R              L   R       |
|                                      |
|                                      |
|                                      |
|                                      |
|                                      |
|       L   R              L   R       |
|                                      |
|                                      |
|                                      |
|                                      |
|                                      |
|                                      |
|                  U                   |
|                                      |
|                                      |
|                                      |
|                  D                   |
|                                      |
|                                      |
|                                      |
|                                      |
________________________________________
|    D     D    D     D    D     D     |
|                                      |
|                                      |
|                                      |
|                                      |
|                                      |
|                                      |
|                                      |
|                                      |
|R                                    L|
|                                      |
|                                      |
|                                      |
|                                      |
|                                      |
|                                      |
|                                      |
|                                      |
|                                      |
|R                                    L|
|                                      |
|                                      |
|                                      |
|                                      |
|                                      |
|                                      |
|                                      |
|                                      |
|                                      |
|R                                    L|
|                                      |
|                                      |
|                                      |
|                                      |
|                                      |
|                                      |
|                                      |
|    U     U    U     U    U     U     |