________________________________________
________________________________________
________________________________________
________________________________________
________________________________________
________________________________________
________________________________________
________________________________________
________________________________________
________________________________________
________________________________________
________________________________________
|                                      |
|                                      |
|                                      |
|                                      |
|                                      |
|                                      |
|                                      |
|                                      |
|                                      |
|                                      |
|                                  0   |
|                                      |
|                        1             |
|                                      |
|                                      |
|                                      |
|                                      |
|                                      |
|                                      |
|                    2                 |
|                                      |
|                                 5    |
|                                      |
|                                      |
|                                      |
|                                      |
|                                      |
|                                      |
|                      3               |
|                                      |
|                                      |
|                                  4   |
|                                      |
|                                      |
|                                      |
|                                      |
|                                      |
|                                      |
________________________________________
________________________________________
________________________________________
________________________________________
|                                      |
|                                      |
|                                      |
|                                      |
|                                      |
|                  e                   |
|                                      |
|                                      |
|                                   d  |
|                                      |
|                                      |
|                                      |
|                                      |
|                                      |
|                                      |
|                                      |
|                                      |
|                                      |
|                                      |
|                                      |
|                                      |
|                                      |
|                                      |
|             f                        |
|                                      |
|                                      |
|                                      |
|                                      |
|                                   c  |
|                                      |
|               a                      |
|                                      |
|                                      |
|                                      |
|                                      |
|                                      |
|                          b           |
|                                      |
________________________________________