________________________________________
|                                      |
| H  H  H  H  H  H  H  H  H  H  H  H H |
|                                      |
|                                      |
| H  H  H  H  H  H  H  H  H  H  H  H H |
________________________________________
|                                      |
|                                      |
|                                      |
|                                      |
|                                      |
|                                      |
|                                      |
|                                      |
|                                      |
|                                      |
|                                      |
|                                      |
|                                      |
| H  H  H                    H  H  H H |
|                                      |
|                                      |
|       H  H  H  H  H  H  H  H         |
|                                      |
|                  v                   |
|       H  H  H     H  H  H  H         |
|                                      |
|                                      |
|       H  H  H  H  H     H  H         |
|                                      |
|                                      |
|       H  H     H  H  H  H  H         |
|                                      |
|                                      |
|       H  H  H  H  H  H  H  H         |
|                                      |
|                                      |
|       H  H  H     H  H  H  H         |
|                                      |
|                                      |
|       H  H  H  H  H  H  H  H         |
|                                      |
|                                      |
|                                      |
________________________________________
________________________________________
|                  d                   |
|                                      |
|                  C                   |
|                                      |
|                                      |
| l                                  l |
|                                      |
|                                      |
|                                      |
|                                      |
|                                      |
|                                      |
|                                      |
|                                      |
|                                      |
|                                      |
|                                      |
|                                      |
|               ttt                    |
|               ttt                    |
|               ttt                    |
|                     ttt              |
|                     ttt              |
|                     ttt              |
|            ttt                       |
|            ttt                       |
|            ttt                       |
|                                      |
|                                      |
|                                      |
|               ttt                    |
|               ttt                    |
|               ttt                    |
|                                      |
|                                      |
|                                      |
|                                      |
|                                      |
________________________________________
|                                      |
|                                      |
|                                      |
|                                      |
|                                      |
|                                      |
|                                      |
|                                      |
|                                      |
|                                      |
|                                      |
|                                      |
|                                      |
| H  H  H                    H  H  H H |
|                                      |
|                                      |
| H  H  H                    H         |
|                                      |
|                                      |
| H  H  H                    H         |
|                                      |
|                                      |
| H  H  H                    H         |
|                                      |
|                                      |
| H  H  H                    H         |
|                                      |
|                                      |
| H  H  H                    H         |
|                                      |
|                                      |
| H  H  H                    H         |
|                                      |
|                                      |
| H  H  H  H  H  H  H  H  H  H         |
|                                      |
|                                      |
| H  H  H  H  H  H  H  H  H  H         |
________________________________________
________________________________________
|D   D   D   D   D   D    D   D   D   D|
|                                      |
|                                      |
|                                      |
|                                      |
|                                      |
|                                      |
|                                      |
|                                      |
|                                      |
|                                      |
| U     U                    U       U |
|                                      |
|         R                L           |
|                                      |
|                                      |
|                                      |
|         R                L           |
|                                      |
|                                      |
|                                      |
|         R                L           |
|                                      |
|                                      |
|                                      |
|         R                L           |
|                                      |
|                                      |
|                                      |
|         R                L           |
|                                      |
|                                      |
|            U   U   U   U             |
|                                      |
|                                      |
|                                      |
|                                      |
|                                      |
________________________________________
|                                      |
|                                      |
|                                      |
|                                      |
|                                      |
|                                      |
|                                      |
|                                      |
|                                      |
|                                      |
|                                      |
|                                      |
|        1                             |
|        K                   H  H  H H |
|        K                             |
|        K                             |
|        K                   H  H  H H |
|        K                             |
|        K                             |
|        K                   H  H  H H |
|        K                             |
|        K                             |
|        K                   H  H  H H |
|        K                             |
|        K                             |
|        K                   H  H  H H |
|        K                             |
|        K                             |
|        K                   H  H  H H |
|        K                             |
|        K                             |
|        K                   H  H  H H |
|        K                             |
|        1kkkkkkkkkkkkkkkkk1           |
|                            H  H  H H |
|                                      |
|                           33333333333|
|                           33333333333|
________________________________________
|                                      |
|                                      |
|                                      |
|                                      |
|                                      |
|                                      |
|                                      |
|                                      |
|                                      |
|                                      |
|                                      |
|                                      |
|        1                             |
|                                      |
|                                      |
|                                      |
|                                      |
|                                      |
|                                      |
|                                      |
|                                      |
|                                      |
|                                      |
|                                      |
|                                      |
|                                      |
|                                      |
|                                      |
|                                      |
|                                      |
|                                      |
|                                      |
|                                      |
|        1                 1           |
|                                      |
|                                      |
|                                      |
|                                      |
________________________________________
|                                      |
|                                      |
|                                      |
|                                      |
|                                      |
|                                      |
|                                      |
|                                      |
|                                      |
|                                      |
|                                      |
|                                      |
|                                      |
|                                      |
|R                                     |
|                                      |
|                                      |
|                                      |
|R                                     |
|                                      |
|                                      |
|                                      |
|R                                     |
|                                      |
|                                      |
|                                      |
|R                                     |
|                                      |
|                                      |
|                                      |
|R                                     |
|                                      |
|                                      |
|                                      |
|R                                     |
|                                      |
|                                      |
|   U   U   U   U   U   U              |
________________________________________
|                                      |
|                                      |
|                                      |
|                                      |
|                                      |
|                                      |
|                                      |
|                                      |
|                                      |
|                                      |
|                                      |
|                                      |
|                           1k1     1k1|
|                           K          |
|                           K          |
|                           K          |
|                           K          |
|                           K          |
|                           K          |
|                           K          |
|                           K          |
|                           K          |
|                           K          |
|                           K          |
|                           K          |
|                           K          |
|                           K          |
|                           K          |
|                           K          |
|                           K          |
|                           K          |
|                           K          |
|                           K          |
|                           K          |
|                           K          |
|                           K          |
|                           K          |
|                           1          |
________________________________________
|                                      |
|                                      |
|                                      |
|                                      |
|                                      |
|                                      |
|                                      |
|                                      |
|                                      |
|                                      |
|                                      |
|                                      |
|                           1 1     1 1|
|                                      |
|                                      |
|                                      |
|                                      |
|                                      |
|                                      |
|                                      |
|                                      |
|                                      |
|                                      |
|                                      |
|                                      |
|                                      |
|                                      |
|                                      |
|                                      |
|                                      |
|                                      |
|                                      |
|                                      |
|                                      |
|                                      |
|                                      |
|                                      |
|                           1          |
________________________________________