________________________________________
|                                      |
| H  H  H  H  H  H  H  H  H  H  H  H H |
|                                      |
|                                      |
| H  H  H  H  H  H  H  H  H  H  H  H H |
________________________________________
|                                      |
|                                      |
|                                      |
|                                      |
|                                      |
|                                      |
|                                      |
|                                      |
|                                      |
|                                      |
|                                      |
|                                      |
|                                      |
| H  H  H                    H  H  H H |
|                                      |
|                                      |
| H  H  H  H  H  H  H  H  H  H  H  H H |
|                                      |
|                  v                   |
| H  H  H  H  H     H  H  H  H  H  H H |
|                                      |
|                                      |
| H  H  H  H  H  H  H     H  H  H  H H |
|                                      |
|                                      |
| H  H  H  H     H  H  H  H  H  H  H H |
|                                      |
|                                      |
| H  H  H  H  H  H  H  H  H  H  H  H H |
|                                      |
|                                      |
| H  H  H  H  H     H  H  H  H  H  H H |
|                                      |
|                                      |
| H  H  H  H  H  H  H  H  H  H  H  H H |
|                                      |
|                                      |
| H  H  H  H  H  H  H  H  H  H  H  H H |
________________________________________
________________________________________
|                  d                   |
|                                      |
|                  C                   |
|                                      |
|                                      |
| l                                  l |
|                                      |
|                                      |
|                                      |
|                                      |
|                                      |
|                                      |
|                                      |
|                                      |
|                                      |
|                                      |
|                                      |
|                                      |
|               ttt                    |
|               ttt                    |
|               ttt                    |
|                     ttt              |
|                     ttt              |
|                     ttt              |
|            ttt                       |
|            ttt                       |
|            ttt                       |
|                                      |
|                                      |
|                                      |
|               ttt                    |
|               ttt                    |
|               ttt                    |
|                                      |
|                                      |
|                                      |
|                                      |
|                                      |
________________________________________
|                                      |
|                                      |
|                                      |
|                                      |
|                                      |
|                                      |
|                                      |
|                                      |
|                                      |
|                                      |
|                                      |
|                                      |
|                                      |
| H  H  H                    H  H  H H |
|                                      |
|                                      |
| H  H  H                    H  H  H H |
|                                      |
|                                      |
| H  H  H                    H  H  H H |
|                                      |
|                                      |
| H  H  H                    H  H  H H |
|                                      |
|                                      |
| H  H  H                    H  H  H H |
|                                      |
|                                      |
| H  H  H                    H  H  H H |
|                                      |
|                                      |
| H  H  H                    H  H  H H |
|                                      |
|                                      |
| H  H  H  H  H  H  H  H  H  H  H  H H |
|                                      |
|                                      |
| H  H  H  H  H  H  H  H  H  H  H  H H |
________________________________________
________________________________________
|                                      |
|                                      |
|                                      |
|                                      |
|                                      |
|                                      |
|                                      |
|                                      |
|                                      |
|                                      |
|                                      |
| U     U                    U       U |
|                                      |
|         R                L           |
|                                      |
|                                      |
|         R                L           |
|                                      |
|                                      |
|         R                L           |
|                                      |
|                                      |
|         R                L           |
|                                      |
|                                      |
|         R                L           |
|                                      |
|                                      |
|         R                L           |
|                                      |
|                                      |
|         R                L           |
|          U  U  U  U  U  U            |
|                                      |
|                                      |
|                                      |
|                                      |
|                                      |
________________________________________
|    D     D     D   D     D     D     |
|                                      |
|                                      |
|                                      |
|                                      |
|                                      |
|                                      |
|                                      |
|                                      |
|                                      |
|                                      |
|                                      |
|                                      |
|                            H  H  H H |
|                                      |
|                                      |
|                            H  H  H H |
|                                      |
|                                      |
|                            H  H  H H |
|                                      |
|                                      |
|                            H  H  H H |
|                                      |
|                                      |
|                            H  H  H H |
|                                      |
|                                      |
|                            H  H  H H |
|                                      |
|                                      |
|                            H  H  H H |
|                                      |
|                                      |
|                            H  H  H H |
|                                      |
|                                      |
|                            H  H  H H |
________________________________________