________________________________________
________________________________________
|                                      |
|                                      |
|                 0                    |
|                                      |
|                                      |
|                                      |
|                                      |
|                                      |
|                                      |
|                       3              |
|                                      |
|                                      |
|                       4              |
|                                      |
|                                      |
|                                      |
|                                      |
|                                      |
|                                      |
|                                      |
|                                      |
|                                      |
|                                      |
|                                      |
|                                      |
|                                      |
|                                      |
|              1        2              |
|                                      |
|                                      |
|                                      |
|                                      |
|                                      |
|                                      |
|                                      |
|                                      |
|                                      |
|                                      |
________________________________________
________________________________________
________________________________________
________________________________________
|                                      |
|                                      |
|                                      |
|                          e           |
|                                      |
|                                      |
________________________________________
________________________________________
|                                      |
|                                      |
|                                      |
|                          e      d    |
|                                      |
|                                      |
|                                      |
|                                      |
|                a                     |
|                                      |
|                                      |
|                                      |
|                                      |
|                                      |
|                                      |
|                                      |
|                                      |
|                                      |
|                                      |
|                                      |
|                                      |
|                                      |
|                                      |
|                                      |
|                                      |
|                                      |
|                                      |
|                                      |
|                                      |
|                                      |
|                                      |
|                                      |
|                                      |
|   b                             c    |
|                                      |
|                                      |
|                                      |
|                                      |
________________________________________