________________________________________
|OO              3 d 3                 |
|O               3 C 3                 |
|            4   3   3   44444444444   |
|            4   33 33   4         4   |
|            4           4         4   |
|  s  l      4           4    l    4   |
|  n         4           4    a    4   |
|       ew   4           4O        4   |
|  e w      O4           4OO       4 X |
|O         OO4444444444444444444   4   |
|4444444444444444444444444444444   4   |
|                                  4   |
|                                  4   |
|                                  4   |
|    X                             4   |
|    XX                            4   |
|      3   333   333   333   3     4   |
|    H 2 H 332 H 332 H 332 H 3     4   |
|      3   333   333   333   3     4 X |
|                            3     4   |
|      3e                    3     4   |
|                3           3     4   |
|  33                        3     4   |
|           3         w3     3     4   |
|           s                3     4   |
|                      3     3     4   |
|  n      3              3   3     4   |
|  3      s    3             3     4 X |
|                    3       3     4   |
|      w3e                   3     4   |
|                  3         3     4   |
| w3                         3     4   |
|          w3            n   3     4   |
|                        3   3     4   |
|     3e        3n   n   s   3     4   |
|33333333333333333333333333  3         |
|                            3        O|
|                l d l       3O      OO|
________________________________________
|                                      |
|                                      |
|                                      |
|                                      |
|                                      |
|                                      |
|                                      |
|                                      |
|                                      |
|                                      |
|                                      |
|                                      |
|                                      |
|                                      |
|                                      |
|    X                                 |
|                                      |
|                                      |
|                                      |
|                                      |
|                                      |
|                                      |
|                                      |
|                                      |
|                                      |
|                                      |
|                                      |
|                                      |
|                                      |
|                                      |
|                                      |
|                                      |
|                                      |
|                                      |
|                                      |
|                                      |
|                                      |
|                                     O|
________________________________________
|                                      |
|                                      |
|                 U U                  |
|                                      |
|                D   D                 |
|                                      |
|                                      |
|                                      |
|                                      |
|                                      |
|                                      |
|                                      |
|                                      |
|                                      |
|                                      |
|      U     U     U     U             |
|                                      |
|      a     a     a     a             |
|                                      |
|      U                               |
|                                      |
|               L R                    |
|    R                 U               |
|   D      L                           |
|           D                          |
|                     L                |
|  U                      R            |
|               R    U                 |
|                                      |
|                                      |
|                                      |
|                  D                   |
|            R                         |
|               U       L              |
|                                      |
|                                      |
|                                      |
|                                      |
________________________________________
|                             D        |
|                          U     U     |
|                                     L|
|                                      |
|                                      |
|                                   R  |
|                                      |
|                                      |
|              U       U              L|
|                                      |
|                                      |
|    D           D           D      R  |
|                                      |
|                                      |
|                                     L|
|                                      |
|                            2         |
|                            2      R  |
|                            2         |
|                            2         |
|                            2    L   L|
|                            2         |
|                            2         |
|                            2      R  |
|                            2         |
|                            2         |
|                            2R       L|
|                            2         |
|                            2         |
|                            2      R  |
|                            2         |
|                            2         |
|                            2R       L|
|                            2         |
|                            2         |
|                            2     D   |
|                            2         |
|                            2         |
________________________________________