________________________________________
|                                      |
|                                      |
|                                      |
|                                      |
|                                      |
|                                      |
|                                      |
|                                      |
|                                      |
|                                      |
|                                      |
|                                      |
|                                      |
|                                      |
|                                      |
|                                      |
|                                      |
|                                      |
|                                      |
|                                      |
|                                      |
|                                      |
|                                      |
|                                      |
|                                      |
|                                      |
|                                      |
|                                      |
|                                      |
|                                      |
|                                      |
|                                      |
|                                      |
|                                      |
|                                      |
|                                      |
|                                      |
|                                      |
________________________________________
________________________________________
________________________________________
|                                      |
|                                      |
|                                      |
|                                      |
|                                      |
|                                      |
|                                      |
|                                      |
|                                      |
|                                      |
|                                      |
|                                      |
|                                      |
|                                      |
|                                      |
|                                      |
|                                     f|
|                                     f|
|                                     f|
|                                     f|
|            fffffffffffffffff        f|
|            f               f         |
|    fffffffff               ffff  ff  |
|                                  ff  |
|                                      |
|  ff                                  |
|  ff                                  |
|                 fffff                |
|           f    ff   ff               |
|  ff   f   f   ff     ff              |
|  ff   f               fffffffff      |
|                                      |
|                                      |
|                             fff      |
|                             fff      |
|                  fffffffff           |
|                                      |
|                                      |
________________________________________