________________________________________
|XXXXX           XXXXX            XXXXX|
|                                      |
|                                      |
|                                      |
|                                      |
|                  P                   |
________________________________________
________________________________________
________________________________________
________________________________________
|XXXXX           XXXXX            XXXXX|
|                                      |
|                                      |
|                                      |
|                                      |
|                  0                   |
________________________________________