________________________________________
________________________________________
|                                      |
|                                      |
|                                      |
|                                      |
|                                      |
|                                      |
|                                      |
|                                      |
|                                      |
|                                      |
|                                      |
|                                      |
|                                      |
|                                 0    |
|                                      |
|                                      |
|                                      |
|                                      |
|                                 7    |
|                     1                |
|                                      |
|        2                             |
|                                      |
|                                      |
|                                      |
|                                      |
|                                      |
|                                      |
|        3                  6          |
|                                      |
|                                      |
|                                      |
|           4              5           |
|                                      |
|                                      |
|                                      |
|                                      |
|                                      |
________________________________________
________________________________________
________________________________________
________________________________________
________________________________________
________________________________________
________________________________________
________________________________________
|                                      |
|                                      |
|                                      |
|                                      |
|                                      |
|                                      |
|                                      |
|                                      |
|                                      |
|                                      |
|                                      |
|                                      |
|                                a     |
|                                      |
|                                h     |
|                                      |
|                     b                |
|                                      |
|                                      |
|                                      |
| c                                    |
|                                      |
|                                      |
|                                      |
|                                      |
|                                      |
|                                      |
| d                                 g  |
|                                      |
|                                      |
|                                      |
|                                      |
|                                      |
|                                      |
|   e                            f     |
|                                      |
|                                      |
|                                      |
________________________________________