________________________________________
________________________________________
|                                      |
|                                      |
|                                      |
|                                      |
|                                      |
|                                      |
|                                      |
|                                      |
|                                      |
|                                      |
|                                      |
|                                      |
|                                      |
|                                      |
|                                      |
|                                      |
|                                      |
|                                      |
|                                      |
|                                      |
|                                      |
|                                      |
|                                      |
|                                      |
|                                      |
|                                      |
|                                      |
|                                      |
|                                      |
|                         3            |
|    4     3  5     4                  |
|          4    443      4   2         |
|     55   5         44                |
|   5      4               3           |
|     6           5     3              |
|                                      |
|                                      |
|                                      |
________________________________________